product_name,category,discounted_price,actual_price,discount_percentage,rating,rating_count,valid_discount
"tizum HDMI to VGA Adapter Cable 1080P for Projector, Computer, Laptop, TV, Projectors & TV","Electronics|HomeTheater,TV&Video|Accessories|Cables|HDMICables",279,499,44%,3.7,10962,-220
7SEVEN® Compatible for Samsung Smart 4K Ultra HD TV Monitor Remote Control Replacement of Original Samsung TV Remote for LED OLED UHD QLED and Suitable for 6 7 8 Series Samsung TV with Hot Keys BN59-01259E,"Electronics|HomeTheater,TV&Video|Accessories|RemoteControls",399,999,60%,3.6,493,-600
Tata Sky Universal Remote,"Electronics|HomeTheater,TV&Video|Accessories|RemoteControls",230,499,54%,3.7,2960,-269
"Airtel DigitalTV DTH Television, Setup Box Remote Compatible for SD and HD Recording (Black)","Electronics|HomeTheater,TV&Video|Accessories|RemoteControls",179,799,78%,3.7,2201,-620
"Gizga Essentials USB WiFi Adapter for PC, 150 Mbps Wireless Network Adapter for Desktop - Nano Size WiFi Dongle Compatible with Windows, Mac OS & Linux Kernel | WPA/WPA2 Encryption Standards| Black",Computers&Accessories|NetworkingDevices|NetworkAdapters|WirelessUSBAdapters,269,800,66%,3.6,10134,-531
"ZEBRONICS ZEB-USB150WF1 WiFi USB Mini Adapter Supports 150 Mbps Wireless Data, Comes with Advanced Security WPA/WPA2 encryption Standards",Computers&Accessories|NetworkingDevices|NetworkAdapters|WirelessUSBAdapters,290,349,17%,3.7,1977,-59
"LOHAYA Remote Compatible for Mi Smart LED TV 4A Remote Control (32""/43"") [ Compatible for Mi Tv Remote Control ] [ Compatible for Mi Smart LED Tv Remote Control ]","Electronics|HomeTheater,TV&Video|Accessories|RemoteControls",249,799,69%,3.8,1079,-550
"Gilary Multi Charging Cable, 3 in 1 Nylon Braided Fast Charging Cable for iPhone Micro USB Type C Mobile Phone | Colour May Vary |",Computers&Accessories|Accessories&Peripherals|Cables&Accessories|Cables|USBCables,345,999,65%,3.7,1097,-654
Electvision Remote Control Compatible with Amazon Fire tv Stick (Pairing Manual Will be Back Side Remote Control)(P),"Electronics|HomeTheater,TV&Video|Accessories|RemoteControls",1299,1999,35%,3.6,590,-700
"Portronics Konnect Spydr 31 3-in-1 Multi Functional Cable with 3.0A Output, Tangle Resistant, 1.2M Length, Nylon Braided(Zebra)",Computers&Accessories|Accessories&Peripherals|Cables&Accessories|Cables|USBCables,228,899,75%,3.8,132,-671
Remote Control Compatible for Amazon Fire Tv Stick Remote Control [ 3rd Gen ](Not Compatible for Fire TV Edition Smart TV) from basesailor,"Electronics|HomeTheater,TV&Video|Accessories|RemoteControls",1499,3999,63%,3.7,37,-2500
Airtel DigitalTV DTH Remote SD/HD/HD Recording Compatible for Television (Shining Black ),"Electronics|HomeTheater,TV&Video|Accessories|RemoteControls",195,499,61%,3.7,1383,-304
"Skadioo WiFi Adapter for pc | Car Accessories, WiFi Dongle for pc | USB WiFi Adapter for pc | Wi-Fi Receiver 2.4GHz, 802.11b/g/n UNano Size WiFi Dongle Compatible Adapter,WiFi dongle for pc",Computers&Accessories|NetworkingDevices|NetworkAdapters|WirelessUSBAdapters,199,499,60%,3.7,612,-300
Sony TV - Remote Compatible for Sony LED Remote Control Works with Sony LED TV by Trend Trail Speed tech & Remote hi Remote & REO India only,"Electronics|HomeTheater,TV&Video|Accessories|RemoteControls",205,499,59%,3.8,313,-294
LOHAYA Television Remote Compatible for VU LED LCD HD Tv Remote Control Model No :- EN2B27V,"Electronics|HomeTheater,TV&Video|Accessories|RemoteControls",299,1199,75%,3.7,490,-900
Storite USB 2.0 A to Mini 5 pin B Cable for External HDDS/Camera/Card Readers 35cm,Computers&Accessories|Accessories&Peripherals|Cables&Accessories|Cables|USBCables,259,699,63%,3.8,2399,-440
"MYVN LTG to USB for Fast Charging & Data Sync USB Cable Compatible for iPhone 5/5s/6/6S/7/7+/8/8+/10/11, iPad Air/Mini, iPod and iOS Devices (1 M)",Computers&Accessories|Accessories&Peripherals|Cables&Accessories|Cables|USBCables,252,999,75%,3.7,2249,-747
Tata Sky Universal Remote Compatible for SD/HD,"Electronics|HomeTheater,TV&Video|Accessories|RemoteControls",204,599,66%,3.6,339,-395
Crypo™ Universal Remote Compatible with Tata Sky Universal HD & SD Set top Box (Also Works with All TV),"Electronics|HomeTheater,TV&Video|Accessories|RemoteControls",299,999,70%,3.8,928,-700
Astigo Compatible Remote for Airtel Digital Set Top Box (Pairing Required with TV Remote),"Electronics|HomeTheater,TV&Video|Accessories|RemoteControls",299,899,67%,3.8,425,-600
Remote Compatible for Samsung LED/LCD Remote Control Works with Samsung LED/LCD TV by Trend Trail,"Electronics|HomeTheater,TV&Video|Accessories|RemoteControls",213,499,57%,3.7,246,-286
Electvision Remote Control for led Smart tv Compatible with VU Smart Led (Without Voice),"Electronics|HomeTheater,TV&Video|Accessories|RemoteControls",349,1999,83%,3.8,197,-1650
7SEVEN® Compatible for Mi tv Remote Control Original Suitable with Smart Android 4K LED Non Voice Command Xiaomi Redmi Remote of 4A Model 32 43 55 65 inches,"Electronics|HomeTheater,TV&Video|Accessories|RemoteControls",349,799,56%,3.6,323,-450
7SEVEN® Compatible Vu Smart Tv Remote Control Suitable for Original 4K Android LED Ultra HD UHD Vu Tv Remote with Non Voice Feature without google assistant,"Electronics|HomeTheater,TV&Video|Accessories|RemoteControls",499,899,44%,3.7,185,-400
SVM Products Unbreakable Set Top Box Stand with Dual Remote Holder (Black),"Electronics|HomeTheater,TV&Video|Accessories|TVMounts,Stands&Turntables|TVWall&CeilingMounts",96,399,76%,3.6,1796,-303
"KRISONS Thunder Speaker, Multimedia Home Theatre, Floor Standing Speaker, LED Display with Bluetooth, FM, USB, Micro SD Card, AUX Connectivity",Electronics|HomeAudio|Speakers|TowerSpeakers,2299,3999,43%,3.8,282,-1700
Amazon Brand - Solimo 3A Fast Charging Tough Type C USB Data Cable  – 1 Meter,Computers&Accessories|Accessories&Peripherals|Cables&Accessories|Cables|USBCables,119,299,60%,3.8,51,-180
"Astigo Compatible Remote Control for Mi Smart LED 4A (43""/32"")","Electronics|HomeTheater,TV&Video|Accessories|RemoteControls",299,599,50%,3.7,708,-300
"Lava Charging Adapter Elements D3 2A Fast Charging Speed Usb Type C Data Cable, White",Computers&Accessories|Accessories&Peripherals|Cables&Accessories|Cables|USBCables,129,449,71%,3.7,41,-320
"PRUSHTI COVER AND BAGS, Protective Case for Airtel Xstream settop Box Remote Remote Control Pouch Cover Holder PU Leather Cover Holder(only Cover for Selling Purpose)","Electronics|HomeTheater,TV&Video|Accessories|RemoteControls",199,499,60%,3.8,538,-300
Airtel DigitalTV HD Setup Box Remote,"Electronics|HomeTheater,TV&Video|Accessories|RemoteControls",197,499,61%,3.8,136,-302
"WeCool Bluetooth Extendable Selfie Sticks with Wireless Remote and Tripod Stand, 3-in-1 Multifunctional Selfie Stick with Tripod Stand Compatible with iPhone/OnePlus/Samsung/Oppo/Vivo and All Phones",Electronics|Mobiles&Accessories|MobileAccessories|Photo&VideoAccessories|Tripods,539,1599,66%,3.8,14648,-1060
"PTron Boom Ultima 4D Dual Driver, in-Ear Gaming Wired Headphones with in-line Mic, Volume Control & Passive Noise Cancelling Boom 3 Earphones - (Dark Blue)","Electronics|Headphones,Earbuds&Accessories|Headphones|In-Ear",299,1900,84%,3.6,18202,-1601
"SWAPKART Flexible Mobile Tabletop Stand, Metal Built, Heavy Duty Foldable Lazy Bracket Clip Mount Multi Angle Clamp for All Smartphones (Pack of 1), Multi Color",Electronics|Mobiles&Accessories|MobileAccessories|Mounts|Bedstand&DeskMounts,251,999,75%,3.7,3234,-748
"Tukzer Capacitive Stylus Pen for Touch Screens Devices, Fine Point, Lightweight Metal Body with Magnetism Cover Cap for Smartphones/Tablets/iPad/iPad Pro/iPhone (Grey)",Electronics|Mobiles&Accessories|MobileAccessories|StylusPens,349,999,65%,3.8,16557,-650
"Tukzer Capacitive Stylus Pen for Touch Screens Devices, Fine Point, Lightweight Metal Body with Magnetism Cover Cap for Smartphones/Tablets/iPad/iPad Pro/iPhone (White)",Electronics|Mobiles&Accessories|MobileAccessories|StylusPens,349,999,65%,3.8,16557,-650
"EN LIGNE Adjustable Cell Phone Stand, Foldable Portable Phone Stand Phone Holder for Desk, Desktop Tablet Stand Compatible with Mobile Phone/iPad/Tablet (Black)",Electronics|Mobiles&Accessories|MobileAccessories|Stands,209,499,58%,3.6,104,-290
"iPhone Original 20W C Type Fast PD Charger Compatible with I-Phone13/13 mini/13pro/13 pro Max I-Phone 12/12 Pro/12mini/12 Pro Max, I-Phone11/11 Pro/11 Pro Max 2020 (Only Adapter)",Electronics|Mobiles&Accessories|MobileAccessories|Chargers|WallChargers,799,3990,80%,3.8,119,-3191
"Lava A1 Josh 21(Blue Silver) -Dual Sim,Call Blink Notification,Military Grade Certified with 4 Day Battery Backup, Keypad Mobile",Electronics|Mobiles&Accessories|Smartphones&BasicMobiles|BasicMobiles,1055,1249,16%,3.8,2352,-194
Prolet Classic Bumper Case Cover for Samsung Galaxy Watch 4 44mm TPU Plated Full Screen Protector (Black),Electronics|WearableTechnology|SmartWatches,265,999,73%,3.7,465,-734
"Storio Kids Toys LCD Writing Tablet 8.5Inch E-Note Pad Best Birthday Gift for Girls Boys, Multicolor (SC1667)","Computers&Accessories|Accessories&Peripherals|Keyboards,Mice&InputDevices|GraphicTablets",217,237,8%,3.8,7354,-20
"HP w100 480P 30 FPS Digital Webcam with Built-in Mic, Plug and Play Setup, Wide-Angle View for Video Calling on Skype, Zoom, Microsoft Teams and Other Apps (Black)",Electronics|Cameras&Photography|VideoCameras,499,1999,75%,3.7,3369,-1500
"Tygot 10 Inches Big LED Ring Light for Camera, Phone tiktok YouTube Video Shooting and Makeup, 10"" inch Ring Light with 7 Feet Long Foldable and Lightweight Tripod Stand",Electronics|Cameras&Photography|Flashes|Macro&RinglightFlashes,799,1999,60%,3.8,12958,-1200
"ZEBRONICS Zeb-Comfort Wired USB Mouse, 3-Button, 1000 DPI Optical Sensor, Plug & Play, for Windows/Mac, Black","Computers&Accessories|Accessories&Peripherals|Keyboards,Mice&InputDevices|Mice",139,299,54%,3.8,3044,-160
"Quantum QHM-7406 Full-Sized Keyboard with (₹) Rupee Symbol, Hotkeys and 3-pieces LED function for Desktop/Laptop/Smart TV Spill-Resistant Wired USB Keyboard with 10 million keystrokes lifespan (Black)","Computers&Accessories|Accessories&Peripherals|Keyboards,Mice&InputDevices|Keyboards",299,599,50%,3.8,3066,-300
"boAt Airdopes 181 in-Ear True Wireless Earbuds with ENx  Tech, Beast  Mode(Low Latency Upto 60ms) for Gaming, with Mic, ASAP  Charge, 20H Playtime, Bluetooth v5.2, IPX4 & IWP (Cool Grey)","Electronics|Headphones,Earbuds&Accessories|Headphones|In-Ear",1598,2990,47%,3.8,11015,-1392
"E-COSMOS 5V 1.2W Portable Flexible USB LED Light (Colors May Vary, Small) - Set of 2 Pieces",Computers&Accessories|Accessories&Peripherals|USBGadgets|Lamps,59,59,0%,3.8,5958,0
"tizum HDMI to VGA Adapter Cable 1080P for Projector, Computer, Laptop, TV, Projectors & TV","Electronics|HomeTheater,TV&Video|Accessories|Cables|HDMICables",279,499,44%,3.7,10962,-220
"Tukzer Capacitive Stylus Pen for Touch Screens Devices, Fine Point, Lightweight Metal Body with Magnetism Cover Cap for Smartphones/Tablets/iPad/iPad Pro/iPhone (Grey)",Electronics|Mobiles&Accessories|MobileAccessories|StylusPens,349,999,65%,3.8,16557,-650
"Wembley LCD Writing Pad/Tab | Writing, Drawing, Reusable, Portable Pad with Colorful Letters | 9 Inch Graphic Tablet (Assorted)","Computers&Accessories|Accessories&Peripherals|Keyboards,Mice&InputDevices|GraphicTablets",235,1599,85%,3.8,1173,-1364
"Gizga Essentials Multi-Purpose Portable & Foldable Wooden Desk for Bed Tray, Laptop Table, Study Table (Black)",Computers&Accessories|Accessories&Peripherals|LaptopAccessories|Lapdesks,549,1999,73%,3.6,6422,-1450
Noise Buds VS201 V2 in-Ear Truly Wireless Earbuds with Dual Equalizer | with Mic | Total 14-Hour Playtime | Full Touch Control | IPX5 Water Resistance and Bluetooth v5.1 (Olive Green),"Electronics|Headphones,Earbuds&Accessories|Headphones|In-Ear",1299,2999,57%,3.8,14629,-1700
MAONO AU-400 Lavalier Auxiliary Omnidirectional Microphone (Black),MusicalInstruments|Microphones|Condenser,478,699,32%,3.8,20218,-221
"ZEBRONICS Zeb-Evolve Wireless in Ear Neckband Earphone with Supporting Bluetooth v5.0, Voice Assistant, Rapid Charge, Call Function & Magnetic Earpiece, with mic (Metallic Blue)","Electronics|Headphones,Earbuds&Accessories|Headphones|In-Ear",499,1499,67%,3.6,9169,-1000
"Airtel AMF-311WW Data Card (Black), 4g Hotspot Support with 2300 Mah Battery",Computers&Accessories|NetworkingDevices|DataCards&Dongles,2099,3250,35%,3.8,11213,-1151
"ZEBRONICS Zeb-Buds 30 3.5Mm Stereo Wired in Ear Earphones with Mic for Calling, Volume Control, Multifunction Button, 14Mm Drivers, Stylish Eartip,1.2 Meter Durable Cable and Lightweight Design(Red)","Electronics|Headphones,Earbuds&Accessories|Headphones|In-Ear",199,499,60%,3.6,2492,-300
"boAt Airdopes 191G True Wireless Earbuds with ENx™ Tech Equipped Quad Mics, Beast™ Mode(Low Latency- 65ms) for Gaming, 2x6mm Dual Drivers, 30H Playtime, IPX5, IWP™, Appealing Case LEDs(Sport Blue)","Electronics|Headphones,Earbuds&Accessories|Headphones|In-Ear",1599,3490,54%,3.7,676,-1891
CP PLUS 2MP Full HD Smart Wi-fi CCTV Security Camera | 360° with Pan Tilt | Two Way Talk | Cloud Monitor | Motion Detect | Night Vision | Supports SD Card (Up to 128 GB) | Alexa & Ok Google | CP-E21A,Electronics|Cameras&Photography|SecurityCameras|DomeCameras,1999,4700,57%,3.8,1880,-2701
"Sony WI-C100 Wireless Headphones with Customizable Equalizer for Deep Bass & 25 Hrs Battery, DSEE-Upscale, Splash Proof, 360RA, Fast Pair, in-Ear Bluetooth Headset with mic for Phone Calls (Black)","Electronics|Headphones,Earbuds&Accessories|Headphones|In-Ear",1599,2790,43%,3.6,2272,-1191
"Zebronics ZEB-VITA Wireless Bluetooth 10W Portable Bar Speaker With Supporting USB, SD Card, AUX, FM, TWS & Call Function",Electronics|HomeAudio|Speakers|BluetoothSpeakers,899,1199,25%,3.8,10751,-300
"ZEBRONICS Zeb-100HB 4 Ports USB Hub for Laptop, PC Computers, Plug & Play, Backward Compatible - Black",Computers&Accessories|Accessories&Peripherals|USBHubs,330,499,34%,3.7,8566,-169
"Silicone Rubber Earbuds Tips, Eartips, Earpads, Earplugs, for Replacement in Earphones and Bluetooth Medium Size (10 Pcs Black)","Electronics|Headphones,Earbuds&Accessories|Earpads",99,999,90%,3.8,594,-900
"Artis AR-45W-MG2 45 Watts MG2 Laptop Adapter/Charger Compatible with MB Air 13” & MB Air 11” (14.5 V, 3.1 A) Connector: MG2 (T Tip Connector)",Computers&Accessories|Accessories&Peripherals|LaptopAccessories|LaptopChargers&PowerSupplies,1699,3499,51%,3.6,7689,-1800
"E-COSMOS 5V 1.2W Portable Flexible USB LED Light (Colours May Vary, Small, EC-POF1)",Computers&Accessories|Accessories&Peripherals|USBGadgets|Lamps,39,39,0%,3.8,3344,0
Inventis 5V 1.2W Portable Flexible USB LED Light Lamp (Colors may vary),Computers&Accessories|Accessories&Peripherals|USBGadgets|Lamps,39,39,0%,3.6,13572,0
"Zebronics Astra 10 Portable Wireless BT v5.0 Speaker, 10W RMS Power, 15* Hours Backup, 2.25"" Drive Size, up to 6.4"" Mobile Holder Support, Carry Handle, USB, mSD, AUX Input and FM Radio with Antenna",Electronics|HomeAudio|Speakers|OutdoorSpeakers,799,1999,60%,3.7,418,-1200
"Gizga Essentials USB WiFi Adapter for PC, 150 Mbps Wireless Network Adapter for Desktop - Nano Size WiFi Dongle Compatible with Windows, Mac OS & Linux Kernel | WPA/WPA2 Encryption Standards| Black",Computers&Accessories|NetworkingDevices|NetworkAdapters|WirelessUSBAdapters,269,800,66%,3.6,10134,-531
"USHA Quartz Room Heater with Overheating Protection (3002, Ivory, 800 Watts)","Home&Kitchen|Heating,Cooling&AirQuality|RoomHeaters|ElectricHeaters",1199,1695,29%,3.6,13300,-496
beatXP Kitchen Scale Multipurpose Portable Electronic Digital Weighing Scale | Weight Machine With Back light LCD Display | White |10 kg | 2 Year Warranty |,Home&Kitchen|Kitchen&HomeAppliances|SmallKitchenAppliances|DigitalKitchenScales,199,1999,90%,3.7,2031,-1800
Prestige PKGSS 1.7L 1500W Electric Kettle (Stainless Steel),Home&Kitchen|Kitchen&HomeAppliances|SmallKitchenAppliances|Kettles&HotWaterDispensers|ElectricKettles,1043,1345,22%,3.8,15592,-302
"Lifelong LLEK15 Electric Kettle 1.5L with Stainless Steel Body, Easy and Fast Boiling of Water for Instant Noodles, Soup, Tea etc. (1 Year Warranty, Silver)",Home&Kitchen|Kitchen&HomeAppliances|SmallKitchenAppliances|Kettles&HotWaterDispensers|Kettle&ToasterSets,549,1000,45%,3.6,1074,-451
"Lifelong LLQH922 Regalia 800 W (ISI Certified) Quartz Room Heater with 2 Power settings, Overheating Protection, 2 Rod Heater (1 Year Warranty, White)","Home&Kitchen|Heating,Cooling&AirQuality|RoomHeaters|ElectricHeaters",999,2000,50%,3.8,1163,-1001
"Pigeon 1.5 litre Hot Kettle and Stainless Steel Water Bottle Combo used for boiling Water, Making Tea and Coffee, Instant Noodles, Soup, 1500 Watt with Auto Shut- off Feature - (Silver)",Home&Kitchen|Kitchen&HomeAppliances|SmallKitchenAppliances|Kettles&HotWaterDispensers|Kettle&ToasterSets,809,1545,48%,3.7,976,-736
"Havells Cista Room Heater, White, 2000 Watts","Home&Kitchen|Heating,Cooling&AirQuality|RoomHeaters|ElectricHeaters",2499,3945,37%,3.8,2732,-1446
Pigeon By Stovekraft ABS Plastic Acer Plus Induction Cooktop 1800 Watts With Feather Touch Control - Black,Home&Kitchen|Kitchen&HomeAppliances|SmallKitchenAppliances|InductionCooktop,1799,3595,50%,3.8,9791,-1796
"Lifelong LLQH925 Dyno Quartz Heater 2 Power settings Tip Over Cut-off Switch 800 Watt Silent operation Power Indicator 2 Rod Room Heater (1 Year Warranty, Grey)","Home&Kitchen|Heating,Cooling&AirQuality|RoomHeaters|ElectricHeaters",1099,2400,54%,3.8,4,-1301
"Lifelong LLFH921 Regalia 2000 W Fan Heater, 3 Air Settings, Room Heater with Overheating Protection, 1 Year Warranty ( White, (ISI Certified, Ideal for small to medium room/area)","Home&Kitchen|Heating,Cooling&AirQuality|RoomHeaters|FanHeaters",899,2000,55%,3.6,291,-1101
Prestige IRIS Plus 750 watt mixer grinder,Home&Kitchen|Kitchen&HomeAppliances|SmallKitchenAppliances|MixerGrinders,3249,6295,48%,3.8,14062,-3046
Maharaja Whiteline Lava Neo 1200-Watts Halogen Heater (White and Red),"Home&Kitchen|Heating,Cooling&AirQuality|RoomHeaters",2499,5000,50%,3.8,1889,-2501
"Bajaj Deluxe 2000 Watts Halogen Room Heater (Steel, ISI Approved), Multicolor","Home&Kitchen|Heating,Cooling&AirQuality|RoomHeaters|HalogenHeaters",1409,1639,14%,3.7,787,-230
"Milton Go Electro 2.0 Stainless Steel Electric Kettle, 1 Piece, 2 Litres, Silver | Power Indicator | 1500 Watts | Auto Cut-off | Detachable 360 Degree Connector | Boiler for Water",Home&Kitchen|Kitchen&HomeAppliances|SmallKitchenAppliances|Kettles&HotWaterDispensers|ElectricKettles,1345,1750,23%,3.8,2466,-405
Crompton Insta Comfy 800 Watt Room Heater with 2 Heat Settings(Grey Blue),"Home&Kitchen|Heating,Cooling&AirQuality|RoomHeaters|ElectricHeaters",1498,2300,35%,3.8,95,-802
USHA Heat Convector 812 T 2000-Watt with Instant Heating Feature (Black),"Home&Kitchen|Heating,Cooling&AirQuality|RoomHeaters|HeatConvectors",2199,2990,26%,3.8,1558,-791
"Lifelong LLMG93 500 Watt Duos Mixer Grinder, 2 Stainless Steel Jar (Liquidizing and Chutney Jar)| ABS Body, Stainless Steel Blades, 3 Speed Options with Whip (1 Year Warranty, Black)",Home&Kitchen|Kitchen&HomeAppliances|SmallKitchenAppliances|MixerGrinders,1149,2499,54%,3.8,4383,-1350
"C (DEVICE) Lint Remover for Woolen Clothes, Electric Lint Remover, Best Lint Shaver for Clothes Pack of 1","Home&Kitchen|Kitchen&HomeAppliances|Vacuum,Cleaning&Ironing|Irons,Steamers&Accessories|LintShavers",469,1599,71%,3.7,6,-1130
"Wipro Vesta 1.8 litre Cool touch electric Kettle with Auto cut off | Double Layer outer body | Triple Protection - Dry Boil, Steam & Over Heat |Stainless Steel Inner Body | (Black, 1500 Watt)",Home&Kitchen|Kitchen&HomeAppliances|SmallKitchenAppliances|Kettles&HotWaterDispensers|Kettle&ToasterSets,1299,1999,35%,3.8,311,-700
"KENT Smart Multi Cooker Cum Kettle 1.2 Liter 800 Watts, Electric Cooker with Steamer & Boiler for Idlis, Instant Noodles, Momos, Eggs, & Steam Vegetables, Inner Stainless Steel & Cool Touch Outer Body",Home&Kitchen|Kitchen&HomeAppliances|SmallKitchenAppliances|Rice&PastaCookers,1599,2900,45%,3.7,441,-1301
"Prestige PRWO 1.8-2 700-Watts Delight Electric Rice Cooker with 2 Aluminium Cooking Pans - 1.8 Liters, White",Home&Kitchen|Kitchen&HomeAppliances|SmallKitchenAppliances|Rice&PastaCookers,2719,3945,31%,3.7,13406,-1226
"Reffair AX30 [MAX] Portable Air Purifier for Car, Home & Office | Smart Ionizer Function | H13 Grade True HEPA Filter [Internationally Tested] Aromabuds Fragrance Option - Black",Car&Motorbike|CarAccessories|InteriorAccessories|AirPurifiers&Ionizers,2339,4000,42%,3.8,1118,-1661
KENT 16088 Vogue Electric Kettle 1.8 Litre 1500 W | Stainless Steel body | Auto shut off over heating protection | 1 Year Warranty,Home&Kitchen|Kitchen&HomeAppliances|SmallKitchenAppliances|Kettles&HotWaterDispensers|ElectricKettles,999,1950,49%,3.8,305,-951
Brayden Fito Atom Rechargeable Smoothie Blender with 2000 mAh Battery and 3.7V Motor with 400ml Tritan Jar (Blue),Home&Kitchen|Kitchen&HomeAppliances|SmallKitchenAppliances|JuicerMixerGrinders,1199,1499,20%,3.8,2206,-300
KENT Gold Optima Gravity Water Purifier (11016) | UF Technology Based | Non-Electric & Chemical Free | Counter Top | 10L Storage | White,Home&Kitchen|Kitchen&HomeAppliances|WaterPurifiers&Accessories|WaterFilters&Purifiers,1699,1900,11%,3.6,11456,-201
HOMEPACK 750W Radiant Room Home Office Heaters For Winter,"Home&Kitchen|Heating,Cooling&AirQuality|RoomHeaters|ElectricHeaters",649,999,35%,3.8,49,-350
"Akiara® - Makes life easy Mini Sewing Machine with Table Set | Tailoring Machine | Hand Sewing Machine with extension table, foot pedal, adapter",Home&Kitchen|Kitchen&HomeAppliances|SewingMachines&Accessories|Sewing&EmbroideryMachines,1484,2499,41%,3.7,1067,-1015
"Usha Steam Pro SI 3713, 1300 W Steam Iron, Powerful steam Output up to 18 g/min, Non-Stick Soleplate (White & Blue)","Home&Kitchen|Kitchen&HomeAppliances|Vacuum,Cleaning&Ironing|Irons,Steamers&Accessories|Irons|SteamIrons",999,1560,36%,3.6,4881,-561
"Wonderchef Nutri-blend Complete Kitchen Machine | 22000 RPM Mixer Grinder, Blender, Chopper, Juicer | 400W Powerful motor | SS Blades | 4 Unbreakable Jars | 2 Years Warranty | Online Recipe Book By Chef Sanjeev Kapoor | Black",Home&Kitchen|Kitchen&HomeAppliances|SmallKitchenAppliances|JuicerMixerGrinders,3299,6500,49%,3.7,11217,-3201
"ROYAL STEP Portable Electric USB Juice Maker Juicer Bottle Blender Grinder Mixer,6 Blades Rechargeable Bottle with (MULTII) (MULTI COLOUR 6 BLED JUICER MIXER)",Home&Kitchen|Kitchen&HomeAppliances|SmallKitchenAppliances|JuicerMixerGrinders,499,2199,77%,3.7,53,-1700
Wipro Vesta 1200 Watt GD203 Heavyweight Automatic Dry Iron| Quick Heat Up| Anti bacterial German Weilburger Double Coated Black Soleplate |2 Years Warranty,"Home&Kitchen|Kitchen&HomeAppliances|Vacuum,Cleaning&Ironing|Irons,Steamers&Accessories|Irons|DryIrons",1049,1950,46%,3.8,250,-901
ACTIVA Instant 3 LTR 3 KVA SPECIAL Anti Rust Coated Tank Geyser with Full ABS Body with 5 Year Warranty Premium (White),"Home&Kitchen|Heating,Cooling&AirQuality|WaterHeaters&Geysers|InstantWaterHeaters",1899,3790,50%,3.8,3842,-1891
"Sui Generis Electric Handheld Milk Wand Mixer Frother for Latte Coffee Hot Milk, Milk Frother, Electric Coffee Beater, Egg Beater, Latte Maker, Mini Hand Blender Cappuccino Maker (Multicolor)",Home&Kitchen|Kitchen&HomeAppliances|SmallKitchenAppliances|HandBlenders,210,699,70%,3.7,74,-489
"Wonderchef Nutri-blend Mixer, Grinder & Blender | Powerful 400W 22000 RPM motor | Stainless steel Blades | 3 unbreakable jars | 2 Years warranty | Online recipe book by Chef Sanjeev Kapoor | Black",Home&Kitchen|Kitchen&HomeAppliances|SmallKitchenAppliances|MixerGrinders,2899,5500,47%,3.8,8958,-2601
Black+Decker Handheld Portable Garment Steamer 1500 Watts with Anti Calc (Violet),"Home&Kitchen|Kitchen&HomeAppliances|Vacuum,Cleaning&Ironing|Irons,Steamers&Accessories|Irons|SteamIrons",3299,4995,34%,3.8,1393,-1696
"PrettyKrafts Laundry Basket for clothes with Lid & Handles, Toys Organiser, 75 Ltr Grey",Home&Kitchen|HomeStorage&Organization|LaundryOrganization|LaundryBaskets,351,1099,68%,3.7,1470,-748
"CSI INTERNATIONAL® Instant Water Geyser, Water Heater, Portable Water Heater, Geyser Made of First Class ABS Plastic 3KW (White)","Home&Kitchen|Heating,Cooling&AirQuality|WaterHeaters&Geysers|InstantWaterHeaters",1049,2499,58%,3.6,328,-1450
"Lifelong Power - Pro 500 Watt 3 Jar Mixer Grinder with 3 Speed Control and 1100 Watt Dry Non-Stick soleplate Iron Super Combo (White and Grey, 1 Year Warranty)",Home&Kitchen|Kitchen&HomeAppliances|SmallKitchenAppliances|MixerGrinders,1699,3398,50%,3.8,7988,-1699
Prestige Clean Home Water Purifier Cartridge,Home&Kitchen|Kitchen&HomeAppliances|WaterPurifiers&Accessories|WaterCartridges,600,640,6%,3.8,2593,-40
"KENT Electric Chopper-B for Kitchen 250 Watt | Chop, Mince, Puree, Whisk, 400 ml Capacity | Stainless Steel Double Chopping Blades | Transparent Chopping Bowl | Anti-Skid | One Touch Operation | Black",Home&Kitchen|Kitchen&HomeAppliances|SmallKitchenAppliances|MiniFoodProcessors&Choppers,1349,2999,55%,3.8,441,-1650
"Inalsa Electric Fan Heater Hotty - 2000 Watts Variable Temperature Control Cool/Warm/Hot Air Selector | Over Heat Protection | ISI Certification, White","Home&Kitchen|Heating,Cooling&AirQuality|RoomHeaters|FanHeaters",1349,2495,46%,3.8,166,-1146
AVNISH Tap Water Purifier Filter Faucet 6 Layer Carbon Activated Dust Chlorine Remover Water Softener for Drinking Cartridge Alkaline Taps for Kitchen Sink Bathroom Wash Basin (6-Layer Filtration),Home&Kitchen|Kitchen&HomeAppliances|WaterPurifiers&Accessories|WaterPurifierAccessories,193,399,52%,3.6,37,-206
"CSI INTERNATIONAL® Instant Water Geyser, Water Heater, Portable Water Heater, Geyser Made of First Class ABS Plastic 3KW (Red)","Home&Kitchen|Heating,Cooling&AirQuality|WaterHeaters&Geysers|InstantWaterHeaters",1049,2499,58%,3.7,638,-1450
Havells Gatik Neo 400mm Pedestal Fan (Aqua Blue),"Home&Kitchen|Heating,Cooling&AirQuality|Fans|TableFans",2399,4200,43%,3.8,397,-1801
Wipro Vesta 1200 Watt GD201 Lightweight Automatic Dry Iron| Quick Heat Up| Stylish & Sleek |Anti bacterial German Weilburger Double Coated Soleplate |2 Years Warranty,"Home&Kitchen|Kitchen&HomeAppliances|Vacuum,Cleaning&Ironing|Irons,Steamers&Accessories|Irons|DryIrons",660,1100,40%,3.6,91,-440
"INALSA Vaccum Cleaner Handheld 800W High Powerful Motor- Dura Clean with HEPA Filtration & Strong Powerful 16KPA Suction| Lightweight, Compact & Durable Body|Includes Multiple Accessories,(Grey/Black)","Home&Kitchen|Kitchen&HomeAppliances|Vacuum,Cleaning&Ironing|Vacuums&FloorCare|Vacuums|HandheldVacuums",1799,3295,45%,3.8,687,-1496
"Milk Frother, Immersion Blender Cordlesss Foam Maker USB Rechargeable Small Mixer Handheld with 2 Stainless Whisks，Wisker for Stirring 3-Speed Adjustable Mini Frother for Cappuccino Latte Coffee Egg",Home&Kitchen|Kitchen&HomeAppliances|SmallKitchenAppliances|HandBlenders,375,999,62%,3.6,1988,-624
"Longway Blaze 2 Rod Quartz Room Heater (White, Gray, 800 watts)","Home&Kitchen|Heating,Cooling&AirQuality|RoomHeaters|ElectricHeaters",929,2199,58%,3.7,4,-1270
"Prestige PWG 07 Wet Grinder, 2L (Multicolor) with Coconut Scraper and Atta Kneader Attachments, 200 Watt",Home&Kitchen|Kitchen&HomeAppliances|SmallKitchenAppliances|Mills&Grinders|WetGrinders,3710,4330,14%,3.7,1662,-620
SaleOn Instant Coal Heater 500W Charcoal Burner Electric Stove Hot Plate - Mix Colors - Pack of 1 - Only Charcoal Heater,Home&Kitchen|Kitchen&HomeAppliances|SmallKitchenAppliances|InductionCooktop,697,1499,54%,3.8,144,-802
ESN 999 Supreme Quality 1500W Immersion Water Heater Rod (Black),"Home&Kitchen|Heating,Cooling&AirQuality|WaterHeaters&Geysers|ImmersionRods",335,510,34%,3.8,3195,-175
"ZIGMA WinoteK WinoteK Sun Instant Water Geyser, Water Heater, Portable Water Heater, Geysers Made of First Class ABS Plastic, automatic Reset Model, AE10-3 W (Yellow)","Home&Kitchen|Heating,Cooling&AirQuality|WaterHeaters&Geysers|InstantWaterHeaters",1190,2550,53%,3.8,1181,-1360
Lifelong LLMG74 750 Watt Mixer Grinder with 3 Jars (White and Grey),Home&Kitchen|Kitchen&HomeAppliances|SmallKitchenAppliances|MixerGrinders,1799,3299,45%,3.8,1846,-1500
VAPJA® Portable Mini Juicer Cup Blender USB Rechargeable with 4 Blades for Shakes and Smoothies Fruits Vegetables Juice Maker Grinder Mixer Strong Cutting Bottle Sports Travel Outdoors Gym (BOTTLE),Home&Kitchen|Kitchen&HomeAppliances|SmallKitchenAppliances|JuicerMixerGrinders,649,999,35%,3.6,4,-350
"Kuber Industries Nylon Mesh Laundry Basket|Sturdy Material & Durable Handles|Netted Lightweight Laundry Bag, Size 36 x 36 x 58, Capicity 30 Ltr (Pink)",Home&Kitchen|HomeStorage&Organization|LaundryOrganization|LaundryBaskets,199,399,50%,3.7,7945,-200
Maharaja Whiteline Odacio Plus 550-Watt Juicer Mixer Grinder with 3 Jars (Black/Silver),Home&Kitchen|Kitchen&HomeAppliances|SmallKitchenAppliances|JuicerMixerGrinders,3349,4799,30%,3.7,4200,-1450
Wolpin 1 Lint Roller with 60 Sheets Remove Clothes Lint Dog Hair Dust (19 x 13 cm) Orange,"Home&Kitchen|Kitchen&HomeAppliances|Vacuum,Cleaning&Ironing|Irons,Steamers&Accessories|LintShavers",179,799,78%,3.6,101,-620
"PrettyKrafts Laundry Square Shape Basket Bag/Foldable/Multipurpose/Carry Handles/Slanting Lid for Home, Cloth Storage,(Single) Jute Grey",Home&Kitchen|HomeStorage&Organization|LaundryOrganization|LaundryBaskets,390,799,51%,3.8,287,-409
Activa Easy Mix Nutri Mixer Grinder 500 Watt | Long Lasting Shock Proof ABS Body | Heavy Duty Motor With Nano - Grinding Technology,Home&Kitchen|Kitchen&HomeAppliances|SmallKitchenAppliances|MixerGrinders,1199,2990,60%,3.8,133,-1791
"Wipro Vesta 1380W Cordless Steam Iron Quick heat up with 20gm/ min Steam Burst, Scratch resistant Ceramic soleplate ,Vertical and Horizontal Ironing, Steam burst of upto .8g/ shot","Home&Kitchen|Kitchen&HomeAppliances|Vacuum,Cleaning&Ironing|Irons,Steamers&Accessories|Irons|SteamIrons",1799,2599,31%,3.6,771,-800
"Larrito wooden Cool Mist Humidifiers Essential Oil Diffuser Aroma Air Humidifier with Colorful Change for Car, Office, Babies, humidifiers for home, air humidifier for room (WOODEN HUMIDIFIRE-A)","Home&Kitchen|Heating,Cooling&AirQuality|Humidifiers",499,799,38%,3.6,212,-300
"IKEA Milk Frother for Your Milk, Coffee,(Cold and hot Drinks), Black","Home&Kitchen|Kitchen&HomeAppliances|Coffee,Tea&Espresso|MilkFrothers",229,399,43%,3.6,451,-170
Usha Hc 812 T Thermo Fan Room Heater,"Home&Kitchen|Heating,Cooling&AirQuality|RoomHeaters|FanHeaters",2320,3290,29%,3.8,195,-970
"Libra Room Heater for Home, Room Heaters Home for Winter, Electric Heater with 2000 Watts Power as per IS Specification for Small to Medium Rooms - FH12 (Grey)","Home&Kitchen|Heating,Cooling&AirQuality|RoomHeaters|ElectricHeaters",949,2299,59%,3.6,550,-1350
"Bajaj Majesty RX10 2000 Watts Heat Convector Room Heater (White, ISI Approved)","Home&Kitchen|Heating,Cooling&AirQuality|RoomHeaters|HeatConvectors",2219,3080,28%,3.6,468,-861
